111111111111111111111111111111
10000000000C000000000000000001
100000000000000000000000000001
1P0000E00000000000000000000001
10000000000000CCCCCCCC00000001
100000000000000000000000000001
100000000000000000000000000C01
111111111111111111111111111111